R  1512 1000

NO ./textures/bark.XPM 
WE ./textures/bricks.XPM
EA ./textures/colorstone.xpm 
SO ./textures/redbrick.XPM
S  ./textures/barrel.xpm


F 12,15,20
C 100,150,255

        1111111111111111111111111
        1000000000110000000000001
        1111000001110000002000001
        1001000000000000E00000001
111111111011000001110000000000001
100000000011000001110111111111111
11111111111111011100000010001
11110110111111011101010010001
11000000110101011100000010001
10002220000000001100000010001
10000000000000001101010010001
110000011101010111110111100011
11110111 1110101 101111010001
11111111 1111111 111111111111