111111111111111111111111111111111111111111111111
100000000000000000000001000000000000000000000001
100000000000000000000001000000000000000000000001
100000000000000000000000000000000000000000000001
100000000000100000000000000000000010000000000001
100000000000100000000001000000000010000000000001
100000001000100000000001000000000010000100000001
100000001000111111111111111111111110000100000001
100000001000000000000001000000000000000100000001
100000001000000000000001000000000000000100000001
100000001000000000000001000000000000000100000001
100000001000000000000001000000000000000100000001
100001111111111111111111111111111111111111100001
100000001000000000000001000000000000000100000001
100000001000000000000001000000000000000100000001
100000001000000000000001000000000000000100000001
100000001000111111111111111111111111000100000001
100000001000100000000001000000000001000100000001
100000000000100000000000000000000001000000000001
100000000000100000000000000000000001000000000001
100000000000000000000001000000000000000000000001
100000000000000000000001000000000000000000000001
111111111111111111111111111111111111111111111111